Team: 33,,,,,,,,,,,,,,,,
Map: 0,,,,,,,,,,,,,,,,
Unit Length: 40,,,,,,,,,,,,,,,,
Unit: cm,,,,,,,,,,,,,,,,
Origin: (0,4),,,,,,,,,,,,,,,
Notes: This is a map of the maze.,,,,,,,,,,,,,,,,
0,0,0,0,0,0,0,0,0,0,0,0,0,0,0,0,0
0,0,0,1,0,0,0,0,0,0,0,1,0,0,0,0,0
1,1,1,1,1,1,1,1,1,1,1,1,0,0,0,0,0
0,0,0,0,0,0,0,0,0,0,1,1,0,0,0,0,0
0,0,0,0,0,0,0,0,0,0,0,0,0,0,0,0,0
0,0,0,0,0,0,0,0,0,0,0,0,0,0,0,0,0
0,0,0,0,0,0,0,0,0,0,0,0,0,0,0,0,0
